32 10
00000000000000000000000000000000
00000000000000000000000000000000
21110000000000000000000000001112
21111111111111111111111111111112
21111110000000000000000001111112
21111110000000000000000001111112
21111111111111111111111111111112
21110000000000000000000000001112
00000000000000000000000000000000
00000000000000000000000000000000