50 10
00000000000000000000000000000000000000000000000000
C-------+20000000000000000000000000000001+-------C
B-------++++++++++++++++++++++++++++++++++-------B
A-------++++++++++++++++++++++++++++++++++-------A
A-------+30000000000000000000000000000004+-------A
A-------+20000000000000000000000000000001+-------A
A-------++++++++++++++++++++++++++++++++++-------A
B-------++++++++++++++++++++++++++++++++++-------B
C-------+30000000000000000000000000000004+-------C
00000000000000000000000000000000000000000000000000