53 10
00000000000000000000000000000000000000000000000000000
C-------+20001++++++++++20000000000000000001+-------C
B-------++++++3000000004+++++++++++++++++++++-------B
A-------++++++2000000001+++++++++++++++++++++-------A
A-------+30004++++++++++30000000000000000004+-------A
A-------+20000000000000000001++++++++++20001+-------A
A-------+++++++++++++++++++++3000000004++++++-------A
B-------+++++++++++++++++++++2000000001++++++-------B
C-------+30000000000000000004++++++++++30004+-------C
00000000000000000000000000000000000000000000000000000